C 225,0,125
F 0,0,0

R 1920 1080

S ./textures/barrel.xpm
NO ./textures/wood.xpm
SO ./textures/wall.xpm
EA ./textures/barrel.xpm
WE ./textures/oversized.xpm

1111111
1001101
1N00001
1111111
