C 225,0,125
F 0,0,0

R 320 200

S ./textures/barrel.xpm
NO ./textures/wood.xpm
SO ./textures/wall.xpm
EA ./textures/wall.xpm
WE ./textures/wood.xpm

1111111111
1000000001
1020000001
1020200001
1000000001
1000001001
1000000101
1000010021
1000010001
1000010021
1000N00001
1020020021
1000000101
1001000001
1010000001
1000010001
1000010001
1000000001
1000010001
1000102021
1001001001
1000000001
1000110101
1000111001
1111111111
