C 225,0,125
F 0,0,0

R 920 800

S ./textures/barrel.xpm
NO ./textures/wood.xpm
SO ./textures/barrel.xpm
EA ./textures/oversized.xpm
WE ./textures/wall.xpm

11111111111111111111
10W000000000000000001
102000000000000000001
10202000000000000111
10000000011111111
1000001001
1000000101
1000010021
1000010001
1000010021
1000000001
1020020021
1000000101
1001000001
1010000001
1000010001
1000010001
1000000001
1000010001
1000102021
1001001001
1000000001
1000110101
1000111001
1111111111
