C 225,0,125
F 0,0,0

R 800 700

S ./textures/barrel.xpm
NO ./textures/eagle.xpm
SO ./textures/mossy.xpm
EA ./textures/colorstone.xpm
WE ./textures/redbrick.xpm

        1111111111111111111111111
        1000000000000000000000001
        1100000000000000000000001
        1000000000000000000000001
111111111000000000000000000000001
100000000000000000000000000001111
10000000000000W10000000000001
10000000000000000000000000001
10000000000002000000000000001
10000000000000000000000000001
10000000000000000001010000001
11000001110101011111011110101
11110111 1110101 101111010001
11111111 1111111 111111111111
